{
  "levelNum" : 1,
  "info" : "Collect all the treasures",
  "tiles":[
    [1,1,0,0,0,0,0,1,0,0,0,0,0,1,1],
    [1,1,0,1,1,1,0,0,0,1,1,1,0,1,1],
    [1,1,0,1,11,1,0,13,0,1,11,1,0,1,1],
    [0,0,0,0,0,8,0,12,0,8,0,0,0,0,0],
    [0,1,5,1,6,1,1,1,1,1,7,1,5,1,0],
    [0,1,11,1,0,2,1,10,1,3,0,1,11,1,0],
    [0,0,0,0,0,11,1,1,1,11,0,0,0,0,0],
    [0,1,11,1,0,2,1,1,1,3,0,1,11,1,0],
    [0,1,1,1,7,1,1,11,1,1,6,1,1,1,0],
    [0,0,0,0,0,0,9 ,0, 9,0,0,0,0,0,0],
    [1,1,1,1,0,1,1 ,0, 1,1,0,1,1,1,1],
    [1,1,1,1,0,1,11 ,0, 11,1,0,1,1,1,1],
    [1,1,1,1,0,1,4 ,0, 4,1,0,1,1,1,1],
    [1,1,1,1,0,0,0 ,0, 0,0,0,1,1,1,1]

  ],
  "numRows": 14,
  "numCols": 15,
  "chap" : {
    "position" : {
      "x" : 7,
      "y" : 6
    }
  },
  "entities" : [],
  "inventory" : [],
  "isAlive" : true
}